111111111
1CCC1CCE1
111CCC111
1PCC1CCC1
111111111