1111111111111111111111111111111111
1E1000000000000C00000C000000000001
1010010100100000101001000000010101
1010010011101010001001000000010101
1P0000001110C0000000000000000001C1
1111111111111111111110111111111111
110000000000000C00000C000000000001
1010010100100000101001000000010101
1010010011101010001001000000010101
110000001110C0000000000000000000C1
1111111111111111111111111111111111