1111111111111111111111111111111111
1E000000A000000C00000C000000000001
101001010010000010100100000A010101
1010010010101010001001000000010101
1P0000000C00CA000000A00000000000C1
1111111111111111111111111111111111