1111111111111111111111111111111111
1E00000A0000000C00000C00000000A001
1010010100100A0010100100C000010101
101001001010101000100100000C010101
1P0000000C00C000CA000000A0000000C1
1111111111111111111111111111111111