111111111
1EC000001
1111P0011
111111111