1111111111111111111111111111111111
1E1000000000000C00000C000000000001
10100101001000001A1001000000010101
1010010011101010001001000000010101
1P0000001110C00000000000000A0000C1
1111111111111111111101111111111111
1111111111111111111101111111111111
1100000000000A0C00000C000000000001
101A010100100000101001000000010101
1010010011101010001001000000010101
110000001110C00000A0000000000000C1
1111111111111111111111111111111111